------------------------???---------------------------------------------------------------------------------------------------?-------------------------------------------------------------------------
---------------------------?-------------------------?--------------------------------------------------------------------------------------------------------------------------------------------------
--------------------------------------------------XXXX--------------------------------------------------------------------------------------------------------o---------------------------BBBBBBBB------
-----------------------------------------------------B----------M-------------------------------------------------------------------------------------------------------------------------?-------------
-----------------------------------------------------------------------------------------M--------------------------------------------------------------------------------------------------------------
------------------------------------------------BBBBBB--------------------------------------------------------------------------------------------------------------------------------------------------
--------------------------------------------------------------------------------------------------------------------------------------X--------------------------------------------------XXXXXX---------
--------------------------------------T----BoB--------M-o-------o------------------?--------------------------------------------------------------------------------------------------------------o----v
-------------------------------------X|-BBBBBBBB------------------------------o-B-----------------------------------------------------------------X----------------------------------------------------f
---------------------------------X----|-----------X----------------------------------------o-------------------------------------------------------------?---------------------------------------------f
---------------------------------XX---|----------XX------------------------X--------------------------------------------------------------------------------------------------------------------???----f
--o--------------T--T------------XXX-X|---------XXX----------------o------XX--------------------------------------------T--------------------------------------------------------X---------------------f
-----------------|--|---?-----B--XXXXX|--------XXXX----------------------XXX----------X---------------------------------|-------------------------------------------------------XX---------------------f
-----------------|--|--M---------XXXXX|-------XXXXX---------------------XXXX---------T----------------------------------|------------T--------------------------------------X--XXX---------------------f
m----------------|--|---------o--XXXXX|--X---XXXXXX-------E------------XXXXX--E------|E------E-------------------------E|------------|--B---------------------E---------------XXXX------------XX------XX
XXXXXXXXX----XXXX|XX|-XXXX----XXXXXXXX|XXX--XXXXXXX------------X----XXXXXXXX--------X|XXXXXXXXMXX---XXXXXXXXXXXXXXXXXXXX|oXXXX---XX--|XXXXXXXXXXXX-XXXXXXX--o--XXXXXXXXXXXXXXXXXXXXXXXXXXXXX---XX--Xo-XX
