-------------------------------------------------------------------------------------------------------------------------------------------------------------------X------------------------------------
-------------------------------------------------------------------------------------------X------------------------------------------------------------------------------------------------------------
--------------------------------------------------------------------------------------------------------------------------------------------------------------------------------------------------------
---------------------------------------------------------------------------------------------------------------M---------------------------------------------B------------------------------------------
--------------------------------------------------------------------------------------------------------------------------------------------------------------------------------------------------------
-o----------------------o-------------------------------------------------------------------------------------------------------------------------------------------------------------------------------
----------------------------------------------------------------------------------------X---------------------------------------------------------------------------------------------------------------
---------------------------------------------------------------------------------------XX--------------------------------------------------------------------------------------------------------------v
-------------------------------------------------------------------------------B------XXX------------??????--------------------------------------------------------------?-----------------------------f
---------------------------------------------------X--------?------------------------XXXX-----------------------------o--------------------------------------------------------------------------------f
-----------------------------------------------B--XX---T----------------------------XXXXX----------------------------------------------------------------------------------o---------------------------f
------------T------------------------------------XXX---|---------------------------XXXXXX--------------------------------XXXXXXXX------------B---------------------------------------------------------f
------------|-----------------------------------XXXX---|--------------------------XXXXXXX--------------------------------------------------------------------------------------------------------------f
------------|----------------------------------XXXXX---|-------------------------XXXXXXXX--------------------------------------------------------------------------------------------------------------f
m-----------|---------------------------------XXXXXX---|--------------E---------XXXXXXXXX-------------------------?-------------------E-------------------------E---------------------------------E----X
XXXXXXXXXXX-|-XXXXXXXXXXXXXXXXXXXXXXXXXXXXXXXXXXXXXXXXX|XXXXXXXX-XXXXXXXXXXXXXXXXXXXXXXXXXXXXX----XXXXXXXXXXXXXXXXXXXXXXXXXXXXXXXXXXoXXXXXXXXXX------XXXXXXXXXXXXXXXXXXXXXXXXXXXXXXXXXXXXXXXXXXXXXXXXXXX
